111111111111
1P0000011001
111100000011
10X000011111
100011000C01
110001000011
1001100000E1
111111111111