111111111111
1P0C000110C1
111100000011
10000X011111
100011000C01
110001000011
1C01100000E1
111111111111