1111111
1P0C001
100X0E1
1111111