1111111
1P000C1
1101111
10000E1
1111111
