1111111111
1P0C0X0001
1XX00000E1
1111111111