1111111
1P0C001
10000E1
1111111