1111111
1P0C0X1
10000E1
1111111