1111111
1PPC0X1
1000EE1
1111111