1111111
1PPC001
1000EE1
1111111