11111111111111111111111111111111111111111111111
100000000000000000001000000110000000000000000E1
10011110000011111111110000000011110001110000001
10101000001110000100000111111111111111010110111
101C1000000000000100000000000100100001010000001
11111111111000111111000000100000000111011100111
10000000001000000100000111111111100001010010001
10011110000000000C000001C1000000010001010010001
10010000111110000111000100111000010001011111001
10010010001000000100000100001111111111010010001
10010111110000001111000000001000001000010010001
10000010001000000100000111111100001111010011101
101100000010000001000000C0000000C00000010000001
10111111111111000100000010001111110000000011101
10110000000010000111111010000000000000010001001
1P110010100000110000000000000000011111110001001
11111111111111111111111111111111111111111111111