1111111111111111111111111111111111111111111111111
1000000000000000000000000000000000000000000000000
1000000000000111111111000000000000000111000000000
1000000000000000010000011111111111111101000000000
1000000000000000010000000000000000000101000000000
1111111111100000010000000000000000000101000000000
1000000000100000010000011111111110000101000000000
10000000000000000C0000010100000000000101000000000
1001000000000000010000010011100000000101000000000
1001000000100000010000010000111111111101000000000
1001011111100000010000000000100000000001000000000
1000001000100000010000011111110000000001000000000
10110000001000000100000000000000C0000001000000000
1011111111111100010000000000111111000000000000000
1011000000001000011111100000000000000000000000000
1P11000000000000000000000000000000000000000000000
1111111111111111111111111111111111111111111111111