1111111111111111111111
10000000010000000000E1
1000000000000000000001
1000000000000000100001
1000000001000000100001
1000000000000000000001
1000000000000000100001
1000000001000000100001
1000000000000000000001
1000000000000000000001
1P00000001000000000001
1111111111111111111111