1111111111111111111111
10001111010000001000E1
100000000001000C000001
1111000C01110000100001
100100000100C000100001
10010C0000000000000001
1001010000010000111001
10011100011100001C0001
10001000000100000C0001
1000100000011110010001
1P00000001000000010001
1111111111111111111111