1111111111111111111111111111111111111111111111111
1P00000000000000000000000000000000000000000000001
1000111100011001100001110001100011001110001111001
1010000000010000000001000001000000001000000000011
1000100111011100111011000001110001111011101100101
1010000000000000000000000000000000001000000000101
1001110011110001100111111110000001100001111000001
1000001000000000001000000000000110000000000000011
1000001011111001111000111100111101000111111000001
1011110000000000000000000000000000000000000011111
1000001000000000111100000000000000000000000000001
1000011010001000100100111100000001111000100011001
1000100011000000100100001001101100000000000000101
1000000011011000111111110001101110001000000000001
100100000000000000000000000000000001000100000C001
1011100000011111111111100001111111011100001111101
1000000000000000000000000000000000000000000000001
10000001111000111111110000000000011110111100000E1
1111111111111111111111111111111111111111111111111
