1111111111111111111111111111111111111111
1P00000000000000000000000000000000000001
1111111111111111111111111111111111111011
1000000000000000000000000000000000000011
1011111111111111111111111111111111111011
1000000000000000000000000000000000000011
1011111111111111111111111111111111111011
1000000000000000000000000000000000000011
1011111111111111111111111111111111111011
1000000000000000000000000000000000000011
1011111111111111111111111111111111111011
1000000000000000000000000000000000000011
1011111111111111111111111111111111111011
1000000000000000000000000000000000000011
1011111111111111111111111111111111111011
1000000000000000000000000000000000000011
1011111111111111111111111111111111111011
10000000000000000000000000000000000000E1
1111111111111111111111111111111111111111
