1111111111111111111111111111111111111111
1P00000000000000000000000000000000000001
1000001111000000001111000000000111000001
1000000000011111000000001111000000000001
1001110000000000001111000000000000000001
1000000000111000000000000000001110000001
1110001110000001111001111000000000000001
1000000000000000000000000000000001110001
1000001110000000000000000000000000000001
1111000000000001111110000000000000000001
1000000000000000000000000000001111000001
10000000000C0000000000000000000000000001
1000001111000000000001111000001110000001
10000000000000000000000000000000000000E1
1000001110000000001110000000001111111001
1000000000000000000000000000000000000001
1000001110000000001110000000000000000001
1000000000000000000000000000000000000001
1111111111111111111111111111111111111111
