1111111
1P00001
10000E1
1111111