1111111
1P00001
1X000E1
1111111