1111111
1P0CX01
1000001
1111111