1111111
100C001
1X000E1
1111111