1111111
100C001
10000E1
1111111