1111111
1P0C0011
10000E1111
11111111111