1111111
1P0C111
10001E1
1111111