1111111111111
1P0C00X000001
100000X000001
100000X000001
100000X0000E1
1111111111111