1111111111111111111111
11111111111111111111E1
1111111111111111111111
1111111111111111111101
1111111111111111111101
1111111111111111111101
11111111111111111111C1
1111111111111111111101
1111111111111111111101
1111111111111111111101
1P00000000000000000001
1111111111111111111111