1111100
1P0C001
1000X01
1111000