1111111
1P0C0011
1000XE1111
11111111111