1111100
1P0C001
1000001
1111000