111111111111
1P0000011001
111100000011
100000011111
100011000C01
110001000011
1001100X00E1
111111111111