1111111111111111111111111111111111111111111111111
1P0000000C000000000000000000000000000000000000001
1001111000111100000001000X00111100100001001111001
101100110110011000000100C00110011011C001011001101
1010000101000010000001000001000010101001010000101
1001100X01000010000001000001000010101001010000001
1000011001000010X00001000001000010100101010011101
1010000101000010000001000001000010100101010000101
10110011011001100C0001000001100110100011011001101
1001111000111100111101111100111100100001001111001
100000000000000CX000000X0000000000000000X000000E1
1111111111111111111111111111111111111111111111111
